############
#        O #
#    P   ###
#O         #
#######  X #######
#  O ##          #
#    ##          #
#          #######
#       XX #
##O X   #  #
############
