#############################
#     X                X   O#
#    P                      #
#XO   X                 X   #
######################    O #
                     #  X   #
                     #    O #
                     #  X   #
                     #    O #
                     ########